椅子	椅子	yǐzi
服	衣服	yīfu
病院	医院	yīyuàn
医師（文語）	医生	yīshēng
一	一	yī
下	下	xià
雨が降る	下雨	xiàyǔ
午後	下午	xiàwǔ
家、家庭	家	jiā
鉄道の駅	火车站	huǒchēzhàn
私	我	wǒ
私たち（聞き手を含めず）	我们	wǒmen
会合、集まり	会	huì
…回	回	huí
学校	学校	xuéxiào
学生	学生	xuésheng
学習する	学习	xuéxí
飲む	喝	hē
見える、目に入る	看见	kànjiàn
喜ぶ、好む	喜欢	xǐhuan
食べる	吃	chī
行く	去	qù
叫ぶ、…と呼ぶ	叫	jiào
九	九	jiǔ
犬	狗	gǒu
…月（日付）	月	yuè
五	五	wǔ
よい、申し分ない	好	hǎo
仕事をする	工作	gōngzuò
うれしい	高兴	gāoxìng
今日	今天	jīntiān
いくらかの（不定の量）	些	xiē
坐る	坐	zuò
さようなら	再见	zàijiàn
料理、おかず	菜	cài
存在する、（…に）ある	在	zài
昨日	昨天	zuótiān
三	三	sān
四	四	sì
字	字	zì
七	七	qī
書く	写	xiě
何、どんな	什么	shénme
住む、止む、止まる	住	zhù
十	十	shí
タクシー	出租车	chūzūchē
娘、女の子	女儿	nǚér
商店	商店	shāngdiàn
小さい、年少である	小	xiǎo
未婚女性への呼びかけ、敬称（英語のMiss…）	小姐	xiǎojie
少ない	少	shǎo
午前	上午	shàngwǔ
人	人	rén
水	水	shuǐ
眠る	睡觉	shuìjiào
…だ、…である	是	shì
週間、曜日	星期	xīngqī
男性に対する敬称（…さん）	先生	xiānsheng
前、前方	前面	qiánmiàn
（…と）思う、考える、懐かしむ	想	xiǎng
彼	他	tā
多い	多	duō
いくら（数量を問う）、いくらか（不定の数量）	多少	duōshǎo
あまりに…すぎる、きわめて	太	tài
電話をかける	打电话	dǎdiànhuà
大きい、年長である	大	dà
お茶	茶	chá
正午、昼	中午	zhōngwǔ
中国	中国	Zhōngguó
助詞（連体修飾・所有）	的	de
天気	天气	tiānqì
…時	点	diǎn
みな、すべて	都	dōu
学友	同学	tóngxué
あの、その、あれ、それ	那	nà
あそこ、そこ	那儿	nàr
二（単独で）	二	èr
太陽、日	日	rì
猫	猫	māo
年	年	nián
…できる（能力がある）、…が起こりうる、…してもよい	能	néng
コップ、さかずき	杯子	bēizi
八	八	bā
きれいである（見た目が）、見事である	漂亮	piàoliang
いいえ、…しない、…ではない	不	bù
どういたしまして	不客气	búkèqi
…分間	分钟	fēnzhōng
ごはん（米の）	米饭	mǐfàn
友人	朋友	péngyou
北京	北京	Běijīng
…しなかった、まだ…していない、まだ…でない	没	méi
かまいません、問題ないです	没关系	méiguānxi
…冊（書籍・ノートを数える）	本	běn
名前	名字	míngzi
明日	明天	míngtiān
いる、ある、待つ	有	yǒu
来る	来	lái
中、内部、範囲を表す	里	lǐ
助詞（動作の完了・実現）	了	le
寒い、冷たい	冷	lěng
ゼロ、数の空位	零	líng
先生（師事する）	老师	lǎoshī
六	六	liù
…と	和	hé
…個（広く色々な名詞に用いる）	个	gè
作る、（仕事などを）する	做	zuò
息子	儿子	érzi
聞く	听	tīng
たいへん、とても	很	hěn
どう、なぜ	怎么	zěnme
どんな（性質）、どう（方法）、どうですか？（状況、意	怎么样	zěnmeyàng
りんご	苹果	píngguǒ
品物	东西	dōngxi
本、書籍	书	shū
買う	买	mǎi
あなた	你	nǐ
感嘆詞（文末、疑問の語気）	吗	ma
感嘆詞（文末、疑問・確認）	呢	ne
どの、どれか	哪	nǎ
どこ、どこの	哪儿	nǎr
感嘆詞（呼びかけ、もしもし）	喂	wèi
通貨の単位、元（口語）	块	kuài
彼女	她	tā
お母さん	妈妈	māma
すみません	对不起	duìbuqǐ
…歳	岁	suì
開く	开	kāi
時刻、時	时候	shíhou
机、テーブル	桌子	zhuōzi
中国語	汉语	Hànyǔ
熱い、暑い	热	rè
愛する、（行い、状態を）好む	爱	ài
お父さん	爸爸	bàba
現在、今	现在	xiànzài
映画	电影	diànyǐng
パソコン	电脑	diànnǎo
テレビ	电视	diànshì
見知っている	认识	rènshi
話す	说话	shuōhuà
お願いする、招待する	请	qǐng
音読する、（学校で）勉強する	读	dú
誰（の）、誰か	谁	shéi
ありがとう	谢谢	xièxie
この、これ	这	zhè
ここ	这儿	zhèr
お金	钱	qián
飛行機	飞机	fēijī
レストラン	饭馆	fànguǎn
お姉さん、姉	姐姐	jiějie
意味	意思	yìsi
いっしょに	一起	yìqǐ
…なので	因为	yīnwèi
右（の方）	右边	yòubian
…できる（客観的な条件で許されている）	可以	kěyǐ
おそらく、…かもしれない	可能	kěnéng
紹介する、説明する	介绍	jièshào
回答する、答える	回答	huídá
速い（速度が）	快	kuài
楽しい	快乐	kuàilè
外	外	wài
仕上げる、尽きる	完	wán
遊ぶ、もてあそぶ	玩	wán
目	眼睛	yǎnjing
希望する	希望	xīwàng
空港	机场	jīchǎng
起床する	起床	qǐchuáng
休憩する	休息	xiūxi
牛乳	牛奶	niúnǎi
去年、昨年	去年	qùnián
教室	教室	jiàoshì
…枚、…件（服、事柄を数える）	件	jiàn
バス	公共汽车	gōnggòngqìchē
…キログラム	公斤	gōngjīn
会社	公司	gōngsī
おいしい	好吃	hǎochī
試験をする	考试	kǎoshì
高い（高さが）	高	gāo
…日（日付）	号	hào
伝える、話す、教える	告诉	gàosu
左（の方）	左边	zuǒbian
再び、さらに、もっと	再	zài
最も、一番	最	zuì
妻、妻子	妻子	qīzi
…回	次	cì
自転車	自行车	zìxíngchē
携帯電話	手机	shǒujī
腕時計	手表	shǒubiǎo
すぐ、じきに	就	jiù
出る、出す	出	chū
準備する、…するつもりだ	准备	zhǔnbèi
だから、ゆえに	所以	suǒyǐ
女性、妻	女人	nǚrén
歌をうたう	唱歌	chànggē
時間	小时	xiǎoshí
笑う	笑	xiào
出勤する	上班	shàngbān
夫、主人	丈夫	zhàngfu
新しい	新	xīn
じつに、確かに	真	zhēn
身体	身体	shēntǐ
果物	水果	shuǐguǒ
（…という）姓である	姓	xìng
晴れている	晴	qíng
ちょうど…している	正在	zhèngzài
誕生日	生日	shēngrì
病気になる	生病	shēngbìng
すいか	西瓜	xīguā
雪	雪	xuě
千	千	qiān
洗う	洗	xǐ
（衣服を）着る、通り抜ける	穿	chuān
船	船	chuán
朝	早上	zǎoshang
歩く、移動する	走	zǒu
送り届ける、贈る、（人を）見送る	送	sòng
バスケットボールをする	打篮球	dǎlánqiú
みんな	大家	dàjiā
第一の	第一	dìyī
しかし、ただし	但是	dànshì
男性、夫	男人	nánrén
助詞（動作の持続・進行）	着	zhe
ダンスをする	跳舞	tiàowǔ
弟	弟弟	dìdi
待つ	等	děng
至る、着く	到	dào
用言につけて結果補語を導く。…できる、…してよい	得	de
白い	白	bái
…と比べて	比	bǐ
非常に、とても、たいへん	非常	fēicháng
百	百	bǎi
切符	票	piào
従業員（ホテルやレストランの）	服务员	fúwùyuán
安い（値段が）	便宜	piányi
忙しい、急いでいる	忙	máng
部屋	房间	fángjiān
妹	妹妹	mèimei
遅い（動作が）	慢	màn
…もまた、たとえ…でも、…でさえも	也	yě
羊肉	羊肉	yángròu
…するつもりである、…する必要がある	要	yào
観光旅行（をする）	旅游	lǚyóu
道路	路	lù
お兄さん、兄	哥哥	gēge
子供	孩子	háizi
それ、あれ	它	tā
すでに	已经	yǐjīng
さがす	找	zhǎo
かたわら、そば	旁边	pángbiān
水泳する	游泳	yóuyǒng
黒い	黑	hēi
二（量詞・位数詞の前で）	两	liǎng
なぜ、どうして	为什么	wèishénme
…してはいけない	别	bié
売る	卖	mài
感嘆詞（語気をやわらげる）	吧	ba
コーヒー	咖啡	kāfēi
丸い	圆	yuán
…対（対になった物を数える）	对	duì
助ける、援助する	帮助	bāngzhù
開始する	开始	kāishǐ
…張り（薄くて平らな面をもつものを数える）	张	zhāng
あなた（敬称）	您	nín
わかる、理解している	懂	dǒng
新聞	报纸	bàozhǐ
時間、時刻	时间	shíjiān
晩、夜	晚上	wǎnshang
歓迎する	欢迎	huānyíng
ひとつひとつ、…ごとに	每	měi
…から（二点間の隔たり）	离	lí
赤い	红	hóng
あげる	给	gěi
薬	药	yào
感じる、思う	觉得	juéde
譲る、…させる、…される	让	ràng
授業	课	kè
高い（値段が）	贵	guì
ジョギングをする	跑步	pǎobù
サッカーをする	踢足球	tīzúqiú
通過する、過ごす	过	guò
運動する	运动	yùndòng
まだ、やはり、なお	还	hái
（ある場所に）入る、前へ進む	进	jìn
遠い	远	yuǎn
誤っている	错	cuò
長い、長さ、長所	长	cháng
門	门	mén
質問する、尋ねる	问	wèn
問題	问题	wèntí
曇っている	阴	yīn
題	题	tí
色	颜色	yánsè
すぐさま、ただちに	马上	mǎshàng
魚	鱼	yú
鶏卵	鸡蛋	jīdàn
おばさん、母の姉妹	阿姨	āyí
あるいは	或者	huòzhě
静かである	安静	ānjìng
その後、今後	以后	yǐhòu
以前、昔	以前	yǐqián
…と考える、思う	以为	yǐwéi
…人（人を数える）	位	wèi
少しの間	一会儿	yíhuìr
全部で、合わせて	一共	yígòng
ずっと；まっすぐ	一直	yīzhí
必ず、きっと	一定	yídìng
同じである、普通である	一般	yìbān
同じである、似ている	一样	yíyàng
一方、片方	一边	yìbiān
雲	云	yún
影響を与える	影响	yǐngxiǎng
…であればあるほど；越える	越	yuè
黄色い	黄	huáng
音楽	音乐	yīnyuè
可愛い	可爱	kěài
夏	夏	xià
果汁、フルーツジュース	果汁	guǒzhī
川	河	hé
花	花	huā
庭、花園	花园	huāyuán
描く（絵や図を）	画	huà
会議	会议	huìyì
解決する	解决	jiějué
恐れる	害怕	hàipà
大通り、街路	街道	jiēdào
通貨の単位、角	角	jiǎo
完成する	完成	wánchéng
きれいである	干净	gānjìng
風邪をひく	感冒	gǎnmào
思い切って…する	敢	gǎn
見る、読む、訪問する、診察する、…と思う	看	kàn
めがね	眼镜	yǎnjìng
おかしい、奇怪である	奇怪	qíguài
機会	机会	jīhuì
季節、シーズン	季节	jìjié
客、乗客	客人	kèrén
足（くるぶし…爪先）	脚	jiǎo
久しい	久	jiǔ
古い	旧	jiù
教える	教	jiāo
近い	近	jìn
文	句子	jùzi
空調、エアコン	空调	kōngtiáo
出会う、当面する	遇到	yùdào
パンダ	熊猫	xióngmāo
月（天体の）	月亮	yuèliang
健康	健康	jiànkāng
公園	公园	gōngyuán
口	口	kǒu
…の方へ、…に対して	向	xiàng
校長、学長	校长	xiàozhǎng
トランク（車の）	行李箱	xínglixiāng
バナナ	香蕉	xiāngjiāo
…刻（15分）	刻	kè
国家	国家	guójiā
…によると	根据	gēnjù
欠ける、異なる	差	chà
最近、近頃	最近	zuìjìn
いま…したばかり、やっと	才	cái
メニュー、お品書き	菜单	càidān
作用、役割、働き；作用する	作用	zuòyòng
宿題	作业	zuòyè
歯を磨く	刷牙	shuāyá
参加する	参加	cānjiā
使う、派遣する、…に…をさせる	使	shǐ
運転手	司机	sījī
字典、辞書	字典	zìdiǎn
そのうえ	而且	érqiě
耳	耳朵	ěrduo
自分	自己	zìjǐ
借りる、貸す	借	jiè
主要な	主要	zhǔyào
必要とする	需要	xūyào
週末、ウィークエンド	周末	zhōumò
秋	秋	qiū
重要である	重要	zhòngyào
おじさん、父親の弟	叔叔	shūshu
祈る、願う	祝	zhù
出現する	出现	chūxiàn
春	春	chūn
…以外は、…を除いて	除了	chúle
注意する、気をつける	小心	xiǎoxīn
カメラ	照相机	zhàoxiàngjī
写真	照片	zhàopiàn
世話をする、気を配る	照顾	zhàogu
インターネットに接続する	上网	shàngwǎng
都会、都市	城市	chéngshì
…本（細長く、曲がることのある物を数える）	条	tiáo
手紙	信	xìn
ニュース	新闻	xīnwén
新鮮である	新鲜	xīnxiān
台所	厨房	chúfáng
水準、レベル	水平	shuǐpíng
数学	数学	shùxué
世界	世界	shìjiè
成績	成绩	chéngjì
はっきりしている	清楚	qīngchu
怒る	生气	shēngqì
声、音	声音	shēngyīn
西	西	xī
つなぐ、（手紙や電話を）受け取る、迎える	接	jiē
先に、まず	先	xiān
お手洗い、トイレ	洗手间	xǐshǒujiān
入浴する	洗澡	xǐzǎo
それから、その後、そして	然后	ránhòu
…双（ペアを数える）	双	shuāng
信じる	相信	xiāngxìn
同じである	相同	xiāngtóng
草	草	cǎo
その他（の）	其他	qítā
実際は	其实	qíshí
なんと…、どんなに（…でも）	多么	duōme
太陽	太阳	tàiyáng
…するつもりだ	打算	dǎsuàn
掃除をする	打扫	dǎsǎo
体育	体育	tǐyù
足（つけ根…くるぶし）	腿	tuǐ
ただ…だけ	只	zhǐ
心配する	担心	dānxīn
短い	短	duǎn
ケーキ、カステラ	蛋糕	dàngāo
…区切り（一定の距離や時間の長さを数える）	段	duàn
土地、地面	地	de
場所、ところ、部分	地方	dìfang
地図	地图	dìtú
地下鉄	地铁	dìtiě
焦る、いらいらする	着急	zháojí
中間、あいだ	中间	zhōngjiān
注意する	注意	zhùyì
スーパーマーケット	超市	chāoshì
低い	低	dī
高くする	提高	tígāo
甘い、うまい	甜	tián
努力している、一生懸命である	努力	nǔlì
冬	冬	dōng
明かり	灯	dēng
当然である	当然	dāngrán
砂糖、あめ	糖	táng
同意する	同意	tóngyì
同僚	同事	tóngshì
特別である	特别	tèbié
突然である	突然	tūrán
南	南	nán
もしも…ならば	如果	rúguǒ
学年	年级	niánjí
若い	年轻	niánqīng
…把（取っ手、柄のあるものを数える）	把	bǎ
暗記する	背	bèi
半分、２分の１	半	bàn
運ぶ、引っ越しする	搬	bān
クラス	班	bān
試合する	比赛	bǐsài
比較する	比较	bǐjiào
鼻	鼻子	bízi
…しなくてはならない	必须	bìxū
演じる	表演	biǎoyǎn
表示する、示す、表す	表示	biǎoshì
標準語（中国の）	普通话	pǔtōnghuà
近所、付近	附近	fùjìn
葡萄	葡萄	pútao
…分	分	fēn
文化	文化	wénhuà
…メートル	米	mǐ
…包み（包んだ物を数える）	包	bāo
置く、放す	放	fàng
安心する	放心	fàngxīn
便利である	方便	fāngbiàn
帽子	帽子	màozi
忘れる、うっかりする	忘记	wàngjì
北方	北方	běifāng
また（…した）	又	yòu
万	万	wàn
明白な；わかる	明白	míngbai
麺類	面条	miàntiáo
パン	面包	miànbāo
有名である	有名	yǒumíng
容易である	容易	róngyì
使う、用いる	用	yòng
要求する	要求	yāoqiú
理解する、調べる	了解	liǎojiě
贈り物	礼物	lǐwù
建物	楼	lóu
年を取っている、古い	老	lǎo
椀、茶碗	碗	wǎn
心地よい、気持ちよい	舒服	shūfu
決定する	决定	juédìng
冷蔵庫	冰箱	bīngxiāng
いくつ（数を尋ねる）、いくつかの（不定の数）	几	jǐ
ほとんど	几乎	jīhū
風が吹く	刮风	guā fēng
泣く	哭	kū
悪い	坏	huài
…したいと思う	愿意	yuànyì
手に取る	拿	ná
遊び	游戏	yóuxì
登山（する）	爬山	páshān
痛む	疼	téng
低い（背丈が）	矮	ǎi
立つ、止まる	站	zhàn
太っている	胖	pàng
スカート	裙子	qúnzi
…といっしょに、…で	跟	gēn
靴	鞋	xié
黒板	黑板	hēibǎn
東	东	dōng
…のために	为	wèi
…のために	为了	wèile
挙行する、行う	举行	jǔxíng
習慣	习惯	xíguàn
傘	伞	sǎn
閉める	关	guān
関係	关系	guānxì
関心をもつ	关心	guānxīn
…に関する	关于	guānyú
興味、趣味	兴趣	xìngqu
つい先ほど、たったいま	刚才	gāngcái
事務室	办公室	bàngōngshì
方法、やりかた	办法	bànfǎ
動物	动物	dòngwù
歴史	历史	lìshǐ
熱が出る	发烧	fāshāo
発見する	发现	fāxiàn
変化する	变化	biànhuà
感嘆詞（文末、感嘆の語気）	啊	a
ビール	啤酒	píjiǔ
図書館	图书馆	túshūguǎn
復習（する）	复习	fùxí
髪の毛	头发	tóufa
祖母（父方の）	奶奶	nǎinai
ホテル	宾馆	bīnguǎn
…枚（重なった物を数える）	层	céng
帯びる、身につける、連れる	带	dài
手伝う	帮忙	bāngmáng
当然…すべきである	应该	yīnggāi
いつも、ずっと	总是	zǒngshì
パスポート	护照	hùzhào
交換する	换	huàn
きわめて；極み、頂点	极	jí
樹木、木	树	shù
検査する、点検する	检查	jiǎnchá
のどが渇いている	渴	kě
満足している（気分的に）	满意	mǎnyì
心がこもっている、親切な；熱情、意欲	热情	rèqíng
趣味、好み	爱好	àihào
祖父（父方の）	爷爷	yéye
環境	环境	huánjìng
電子メール	电子邮件	diànzǐyóujiàn
エレベーター	电梯	diàntī
やせている	瘦	shòu
大きな皿	盘子	pánzi
離れる、別れる	离开	líkāi
種、種子	种	zhǒng
箸	筷子	kuàizi
簡単である	简单	jiǎndān
練習する	练习	liànxí
ついに	终于	zhōngyú
常に、いつも	经常	jīngcháng
社長、経営者；経営する、管理する	经理	jīnglǐ
（ある場所を）通過する、経験する	经过	jīngguò
結婚する	结婚	jiéhūn
終わる、けりがつく	结束	jiéshù
緑色の	绿	lǜ
聡明である、賢い	聪明	cōngming
顔	脸	liǎn
記念日、祝日	节日	jiérì
番組、プログラム	节目	jiémù
青い	蓝	lán
…ではある（けれども…）	虽然	suīrán
ブラウス、シャツ	衬衫	chènshān
ズボン	裤子	kùzi
会う	见面	jiànmiàn
まじめである、真剣である	认真	rènzhēn
…と認める、思う、考える	认为	rènwéi
覚えている	记得	jìde
話す、言う、説明する	讲	jiǎng
字句、語句	词语	cíyǔ
…両（車両を数える）	辆	liàng
過去	过去	guòqu
依然として、（比較して）やはり、それとも	还是	háishì
遅刻する	迟到	chídào
選択（する）	选择	xuǎnzé
隣近所の人	邻居	línjū
鉛筆	铅笔	qiānbǐ
銀行	银行	yínháng
鍛える	锻炼	duànliàn
難しい、…しにくい	难	nán
悲しい	难过	nánguò
満腹である	饱	bǎo
おなかがすいている	饿	è
馬	马	mǎ
乗る（またがって）	骑	qí
鳥	鸟	niǎo
